Mm, Mm, Mm, Mm, Gs, Mm, Mm, Mm, Hh, Hh, Hh, Mm, Mm, Ww, Ww, Mm, Hh, Hh, Hh, Mm, Mm, Mm
Mm, Mm, Mm, Mm, Gs^Vht, Mm, Mm, Mm, Hh, Hh, Hh, Mm, Mm, Ww, Ww, Mm, Hh, Hh, Hh, Mm, Mm, Mm
Mm, Mm, Mm, Mm, Hh, Mm, Hh, Hh, Hh, Hh, Gg, Hh, Hh, Mm, Gs^Fds, Ww, Hh, Gs^Fms, Gs^Vht, Hh, Hh, Hh
Mm, Mm, Hh, Hh, Hh, Hh, Hh, Hh, 2 Co^Kov, Co, Re, Gg, Gs^Vht, Gs^Fds, Gs^Fds, Ww, Gs^Fms, Gs^Fms, Gs^Fp, Gs^Fms, Hh, Hh
Hh, Hh, Hh, Hh, Gs^Vht, Hh, Gs^Fds, Co, Co, Co, Gg, Re, Gg, Gg, Ww, Ww, Gs^Fms, Gs^Fp, Gs^Fms, Gs^Fp, Hh, Hh
Hh, Hh, Gg, Hh, Hh, Hh, Gg, Gs^Fds, Gs^Fds, Gs^Fds, Re, Gs^Vht, Gg, Gg^Efm, Ww, Gg, Gg, Gs^Fp, Gs^Fp, Gs^Fp, Gg, Gg
Hh, Hh, Gs^Fds, Gg, Gg, Re, Gg, Gs^Fds, Gg, Gg, Re, Gg, Gg, Gg, Ww, Gg, Ss, Ss, Ss, Ss, Ss, Ss
Hh, Hh, Gs^Fds, Gg, Gs^Vht, Re, Re, Gg, Gs^Vht, Re, Gg, Re, Gs^Vht, Ww, Gg, Gg, Ss, Ss, Gs^Fp, Ss, Ss, Ss
Hh, Hh, Gs^Fds, Gs^Fds, Gg^Efm, Gg^Efm, Re, Re, Re, Re, Gg, Gg, Gg^Efm, Ww, Ww, Ww, Ss, Ss, Ss, Gs^Fp, Ss, Ss
Gg, Gg, Gg, Gg, Re, Re, Gg, Gg, Gg, Re, Gg, Gs^Fp, Gg^Efm, Ww, Ss, Ss, Ss, Ss, Ss, Ss, Ss, Ss
Gg, Gg, Gs^Fds, Gs^Vht, Gs^Fds, Gs^Fds, Gg, Gs^Vht, Gg, Re, Gg, Gg, Gg, Ww, Ss, Ss, Ss, Ss, Ss, Ss, Ss, Ss
Re, Re, Re, Gg, Re, Gg, Gs^Fds, Gg, Re, Re, Gs^Vht, Gs^Fp, Gs^Fp, Gs^Fp, Hh, Gs^Vht, Hh, Gs^Fp, Gs^Fp, Ss, Ss, Ss
Gg, Gg, Gg, Re, Gg, Re, Re, Gs^Fds, Re, Gg, Gs^Fp, Gs^Fp, Gs^Fp, Gs^Fp, Gg, Gg, Hh, Hh, Hh, Gs^Fp, Hh, Hh
Gs^Fds, Gs^Fds, Gs^Fds, Gg, Gg, Gg, Gs^Vht, Re, Gg, Gg, Gs^Fp, Gs^Fp, Gg, Gg, Gs^Fp, Gg, Gs^Fp, Hh, Gs^Fp, Hh, Hh, Hh
Gs^Fds, Gs^Fds, Gs^Fds, Gs^Fds, Gs^Fms, Gg, Gs^Fms, Gs^Fms, Gs^Fp, Gs^Fms, Gs^Fp, Gs^Fp, Gg, Gg, Gs^Fp, Gg, Gs^Fp, Gg, Gs^Fp, Gs^Fp, Gs^Fp, Gs^Fp
Gg, Gg, Gs^Fms, Gg, Gg, Gs^Fms, Gs^Fms, Gg^Efm, Gs^Fms, Gs^Fp, Gs^Fp, Gg, Gg, Gs^Fp, Ce, Gs^Fp, Gg, Gs^Fp, Gs^Fp, Gg^Efm, Gs^Fp, Gs^Fp
Gg, Gg, Gg^Efm, Gg, Gs^Fms, Gg, Gg, Gs^Fp, Gs^Fp, Gg, Gs^Fp, Gs^Fp, Gs^Fp, Ce, 1 Ke, Ce, Gs^Fp, Gs^Fp, Gs^Fp, Gs^Fp, Gs^Fp, Gs^Fp
Hh, Hh, Hh, Gs^Fds, Gs^Fms, Gs^Fms, Gs^Fms, Gg, Gg^Efm, Gs^Fp, Gs^Fp, Gg, Gs^Fp, Ce, Ce, Ce, Gs^Fp, Gs^Fp, Gg, Gs^Fp, Gs^Fp, Gs^Fp
Hh, Hh, Hh, Hh, Hh, Gs^Fms, Gs^Fp, Gg^Efm, Gs^Fp, Gs^Fp, Gg, Gs^Fp, Gs^Fp, Gs^Fp, Gs^Fp, Gs^Fp, Gs^Fp, Gg, Gs^Fp, Gs^Fp, Mm, Mm
Mm, Mm, Mm, Hh, Hh, Hh, Hh, Gs^Fms, Gs^Fp, Gs^Fp, Gs^Fp, Gs^Fp, Gs^Fp, Gs^Fp, Gs^Fp, Gs^Fp, Gs^Fp, Gs^Fp, Hh, Hh, Mm, Mm
Mm, Mm, Mm, Mm, Mm, Hh, Mm, Mm, Mm, Mm, Mm, Gs^Fp, Gs^Fp, Gg, Gs^Fp, Gs^Fp, Hh, Hh, Mm, Mm, Mm, Mm
Mm, Mm, Mm, Mm, Mm, Hh, Mm, Mm, Mm, Mm, Mm, Gs^Fp, Gs^Fp, Gg, Gs^Fp, Gs^Fp, Hh, Hh, Mm, Mm, Mm, Mm
