Xu, Xu, Xu, Xu, Xu, Xu, Xu, Xu, Xu, Xu, Xu, Xu, Xu, Xu, Xu, Xu, Xu, Xu, Xu, Xu, Xu, Xu, Xu, Xu, Xu, Xu, Xu, Xu, Xu, Xu, Xu, Xu
Xu, Xu, Ww, Xu, Ww, Xu, Uu^Vud, Xu, Ww, Xu, Xu, Xu, Xu, Xu, Xu, Xu, Xu, Xu, Uu^Ii, Xu, Wog, Xu, Xu, Xu, Xu, Xu, Xu, Xu, Uu^Vud, Xu, Xu, Xu
Xu, Xu, Uu^Vud, Ww, Uu, Uu, Uu, Uu, Uu, Ww, Uu, Uu^Vud, Xu, Xu, Xu, Uh, Ss, Uu^Ii, Ss, Ss, Ss, Uu^Uf, Xu, Xu, Xu, Xu, Xu, Xu, Uu, Uu, Xu, Xu
Xu, Xu, Xu, Uu, Uu^Vud, Uu, Uu, Uu, Xu, Uu, Uu, Uu, Xu, Xu, Uu^Ii, Ss, Ss, Ss, Ss, Ss, Ss, Uu, Uu, Xu, Xu, Xu, Xu, Xu, Uu, Uh, Xu, Xu
Xu, Xu, Xu, Xu, Xu, Uu, Uu, Xu, Xu, Uh, Uu^Vud, Xu, Xu, Uu^Ii, Uu, Ss, Ss, Ss, Ss, Ss, Ss, Uu, Uu, Uh, Uh, Xu, Uu^Uf, Uu^Uf, Uu, Uh, Xu, Xu
Xu, Xu, Xu, Xu, Xu, Xu, Xu, Uu, Uu, Xu, Xu, Xu, Xu, Uh, Uu, Ss, Ss, Ss, Ss, Ss, Xu, Uu, Uu, Uh, Uh, Uh, Uu, Uu, Uu, Uh, Xu, Xu
Xu, Xu, Xu, Xu, Xu, Xu, Xu, Xu, Xu, Uu, Xu, Xu, Xu, Uu, Uu, Uu, Uu, Ss, Xu, Xu, Uu, Uu, Xu, Uu, Uu, Uh, Xu, Uu, Uu, Xu, Xu, Xu
Xu, Xu, Xu, Xu, Uh, Uh, Uu, Uu, Uu, Uu, Xu, Xu, Uu, Uu, Xu, Uu, Uu, Wog, Xu, Uu, Uh, Xu, Xu, Uu^Vud, Uu, Uu, Uu, Uu, Uu, Xu, Xu, Xu
Xu, Xu, Xu, Uh, Uu, Uu, Uu, Xu, Uu, Uu, Uu, Uu, Uu, Uu, Xu, Xu, Uu, Wog, Wog, Xu, Xu, Uh, Uh, Xu, Xu, Uu, Uu, Uu, Xu, Uu^Vud, Xu, Xu
Xu, Xu, Uu^Vhs, Uu, Xu, Xu, Uu, Xu, Uh, Uu, Uu, Uu, Uu, Uu, Uu, Xu, Uu, Uu, Uu, Wog, Wog, Xu, Xu, Uh, Uu, Uu, Uu, Xu, Xu, Uh, Xu, Xu
Xu, Xu, Uu, Uu, Uu, Uu, Uu, Uh, Uu, Uu, Uu^Vhs, Xu, Uu, Re, Uu, Xu, Uu^Vhs, Uu, Uu, Uu, Uu, Wog, Wog, Xu, Xu, Uu, Uu, Uu, Uu^Vud, Uh, Xu, Xu
Xu, Xu, Xu, Uu, Uu, Uu, Uu, Uu, Uu, Uu, Xu, Xu, Uu, Re, Uu, Xu, Xu, Xu, Xu, Uu, Xu, Xu, Xu, Wog, Xu, Uh, Uu, Uu, Uu, Uu, Xu, Xu
Xu, Xu, Xu, Xu, Uu, Uu, Uu, Xu, Xu, Uu, Uu, Xu, Uu^Uf, Uu, Uu, Uu, Uu, Uu, Uu, Xu, Uu, Uu, Xu, Wog, Qxu, Uu, Cud, Cud, Cud, Uu, Xu, Xu
Xu, Xu, Uu, Uu, Xu, Uu, Uu, Uu^Uf, Uu^Uf, Xu, Uu, Uu, Uu, Uu, Re, Re, Uu, Re, Uu, Re, Re, Uu^Uf, Uu, Xu, Xu, Qxu, Cud, 2 Kud, Cud, Uu, Xu, Xu
Xu, Xu, Uu, Xu, Uu^Uf, Xu, Xu, Uu, Uu, Xu, Re, Uu, Uu, Re, Uu, Uu, Xu, Uu, Xu, Uu, Uu, Re, Uu, Uu, Xu, Qxu, Qxu, Cud, Uu, Uu, Xu, Xu
Xu, Xu, Uu^Uf, Uu^Uf, Uu^Uf, Uu^Uf, Uu^Uf, Uu, Re, Re, Uu, Xu, Uu^Vhs, Uu, Xu, Xu, Ha, Xu, Ha, Xu, Xu, Uu, Re, Uu, Uu, Xu, Qxu, Uu, Xu, Xu, Xu, Xu
Xu, Xu, Uu^Uf, Xu, Uu^Uf, Uu^Uf, Xu, Uu, Uu, Uu, Xu, Xu, Xu, Xu, Ms, Aa^Fpa, Aa^Fma, Ha, Ha, Ha, Xu, Uu, Re, Uu, Uu, Xu, Xu, Xu, Xu, Xu, Xu, Xu
Xu, Xu, Uu^Uf, Xu, Cud, Cud, Cud, Xu, Uu, Uu, Xu, Xu, Aa^Fma, Aa^Fpa, Aa^Fma, Aa^Fma, Aa, Aa, Aa^Fma, Aa, Re, Re, Uu, Uu, Uu, Xu, Xu, Xu, Xu, Xu, Xu, Xu
Xu, Xu, Xu, Uu, Cud, 3 Kud, Cud, Uu, Uu, Uu^Vhs, Xu, Xu, Ms^Xm, Aa^Fma, Aa, Aa, Aa^Fma, Aa^Fma, Cea, Aa^Fma, Aa^Fma, Re, Xu, Xu, Xu, Xu, Xu, Xu, Xu, Xu, Xu, Xu
Xu, Xu, Xu, Uu, Uu, Cud, Uu, Uu, Uu, Uu, Xu, Xu, Ms^Xm, Ms, Aa, Aa, Aa^Fma, Cea, Cea, Cea, Cea, Aa, Aa^Fma, Ms, Ms, Xu, Xu, Xu, Xu, Xu, Xu, Xu
Xu, Xu, Xu, Xu, Xu, Uu, Xu, Uu^Uf, Xu, Uu^Vhs, Xu, Xu, Ms, Ms, Ha, Ha^Fma, Ha, Aa, Aa, 1 Kea, Ha, Aa^Fma, Aa, Ha, Xu, Xu, Xu, Xu, Xu, Xu, Xu, Xu
Xu, Xu, Xu, Xu, Xu, Xu, Xu, Xu, Xu, Xu, Xu, Xu, Ms, Ms, Ha, Ha^Fma, Ha, Aa, Aa, Aa, Ha, Aa^Fma, Aa, Ha, Xu, Xu, Xu, Xu, Xu, Xu, Xu, Xu
