Gs^Fp, Gs^Fp, Gs^Fp, Gs^Fp, Gs^Fp, Gs^Fp, Gs^Fp, Gs^Fp, Gs^Fp, Gs^Fp, Gs^Fp, Gs^Fp, Gg, Re, Gg, Gg, Gg, Hh, Hh, Hh, Mm, Mm, Mm, Mm, Mm, Mm^Xm, Mm^Xm, Mm^Xm, Mm, Mm, Mm, Mm, Mm^Xm, Mm, Mm^Xm, Mm, Mm^Xm, Mm, Mm, Mm, Mm, Mm
Gs^Fp, Gs^Fp, Gs^Fp, Gs^Fp, Gs^Fp, Gs^Fp, Gs^Fp, Gs^Fp, Gs^Fp, Gs^Fp, Gs^Fp, Gs^Fp, Gg, Re, Gg, Gg, Gg, Hh, Hh, Hh, Mm, Mm, Mm, Mm, Mm, Mm^Xm, Mm^Xm, Mm^Xm, Mm, Mm, Mm, Mm, Mm^Xm, Mm, Mm^Xm, Mm, Mm^Xm, Mm, Mm, Mm, Mm, Mm
Gs^Fp, Gs^Fp, Gs^Fp, Gs^Fp, Gs^Fp, Gg^Fet, Gs^Fp, Gs^Fp, Chr, Gs^Fp, Gs^Fp, Gs^Fp, Gg, Re, Gs^Fp, Gg, Gg, Hh, Hh, Hh, Hh, Mm, Mm, Mm, Mm, Mm, Mm, Mm, Mm, Mm, Mm, Mm, Mm, Mm^Xm, Mm^Xm, Mm, Mm^Xm, Mm^Xm, Mm^Xm, Mm, Mm, Mm
Gs^Fp, Gs^Fp, Gs^Fp, Gg^Vo, Gs^Fp, Gs^Fp, Gs^Fp, Chr, 2 Khr, Chr, Gg, Gg, Gs^Fp, Re, Gg, Gs^Fp, Gg, Hh, Hh, Hh, Hh, Hh, Mm, Mm, Hh, Hh, Hh^Vo, Mm, Mm, Mm, Hh, Mm, Mm, Mm, Mm, Mm^Xm, Mm^Xm, Mm^Xm, Mm^Xm, Mm^Xm, Mm, Mm
Gs^Fp, Gs^Fp, Gs^Fp, Gs^Fp, Gg, Gs^Fp, Gs^Fp, Chr, Chr, Chr, Gg, Gs^Fp, Re, Re, Gs^Fp, Gg, Gg, Gs^Fp, Gg, Hh, Hh, Hh, Hh, Hh, Hh, Hh, Hh, Hh, Hh, Hh, Hh, Hh, Mm, Mm, Mm, Mm, Mm, Mm^Xm, Mm, Mm^Xm, Mm^Xm, Mm^Xm
Gs^Fp, Gs^Fp, Gs^Fp, Gg^Fet, Gs^Fp, Gs^Fp, Gs^Fp, Gs^Fp, Gs^Fp, Gg, Re, Re, Gg, Gg, Gg, Gg, Gg^Vo, Gg, Gs^Fp, Hh, Hh, Hh, Gg, Gg, Gg, Hh, Hh, Hh, Hh, Hh, Hh, Hh, Hh, Mm, Mm, Mm, Mm, Mm, Mm, Mm, Mm^Xm, Mm^Xm
Gs^Fp, Gs^Fp, Gg^Vo, Gs^Fp, Gs^Fp, Gs^Fp, Gs^Fp, Gs^Fp, Gs^Fp, Gg, Gs^Fp, Gg, Gg, Gg, Gg, Gg, Gs^Fp, Gg, Gg, Gs^Fp, Gg, Gg, Gg, Gg, Gg, Gg, Gg, Hh, Gg, Hh, Hh, Hh, Hh, Hh, Hh, Hh, Hh, Mm, Hh^Vc, Mm, Mm, Mm
Gs^Fp, Gs^Fp, Gs^Fp, Gs^Fp, Gg, Gs^Fp, Gg, Gs^Fp, Gs^Fp, Gg, Gg, Gg, Gg, Gg, Gg, Gg, Gg, Gg, Gg, Gg, Gg, Gg^Efm, Gg, Gg, Gg^Efm, Gg, Gg, Gg, Gg, Gg, Gs^Fp, Hh, Hh, Hh, Hh, Hh, Hh, Hh, Hh, Hh, Mm, Mm
Gs^Fp, Gs^Fp, Gs^Fp, Gs^Fp, Gs^Fp, Gs^Fp, Gs^Fp, Gg, Gs^Fp, Gg, Gg, Gs^Fp, Gg^Fet, Gg, Gs^Fp, Gg, Gg, Gg, Gg^Vo, Gg, Gg, Gg, Gg, Gg, Gg^Vc, Gg, Gg, Gg, Gg, Gs^Fp, Gg^Fet, Gg, Gg^Vo, Gs^Fp, Gs^Fp, Hh, Gg^Fet, Hh, Hh, Hh, Gg, Gg
Gg, Gg, Gs^Fp, Gg, Gs^Fp, Gs^Fp, Gs^Fp, Gs^Fp, Gg^Vo, Gs^Fp, Gg, Gg, Gs^Fp, Gg, Gg, Gg, Gg^Efm, Gg, Gg, Gs^Fp, Gg, Gg, Gg, Gg, Gg, Gg, Gg, Gg^Efm, Gg, Gg, Gs^Fp, Gs^Fp, Gg, Gs^Fp, Gs^Fp, Gs^Fp, Gg^Fet, Gg^Fet, Gs^Fp, Gs^Fp, Gg^Fet, Gs^Fp
Ww, Gs^Fp, Gg^Fet, Gs^Fp, Gg, Gs^Fp, Gg, Gs^Fp, Gs^Fp, Gs^Fp, Gg, Gg, Gg, Gg, Gg, Gg, Gg, Gg, Gg, Gg, Gg, Gg, Gg, Gg, Gg, Gg, Gg, Gg, Gg, Gg, Gg, Gg, Gg, Gs^Fp, Gs^Fp, Gg, Gg, Gs^Fp, Gg^Vo, Gs^Fp, Gs^Fp, Gs^Fp
Ww, Ww, Ww, Gs^Fp, Ww, Gg, Ww, Gg, Ww, Gg, Gg, Gg, Gg, Gg, Gs^Fp, Gg, Gg, Gg, Gg, Gg, Gg, Gg, Gg, Gg, Gg, Gg, Gg, Gg, Gg, Gg, Gg, Gg, Gg, Gg, Gs^Fp, Gg, Re, Gs^Fp, Gg, Gs^Fp, Re, Re
Ww, Ww, Ww, Ww, Ww, Ww, Ww, Ww, Ww, Ww, Ww, Gg, Gg, Gg, Gg, Gg^Efm, Gg, Gg, Gg, Gg, Gg, Gg, Gg, Gg, Gg, Gg, Gg, Gg, Gg, Gg^Efm, Gg, Gg, Gg, Gg, Gg, Re, Gs^Fp, Re, Re, Re, Gs^Fp, Gs^Fp
Gg, Ww, Ww, Ww, Wo, Wo, Wo, Ww, Ww, Ww, Ww, Gg, Gg, Gg, Gg, Gg, Gg, Gg, Gg, Gg^Efm, Gg, Gg, Gg, Gg^Efm, Gg, Gg, Gg, Gg, Gg, Gg, Gg, Gg, Ce, Ce, Ce, Gg, Gs^Fp, Gs^Fp, Gs^Fp, Gs^Fp, Gs^Fp, Gs^Fp
Hh, Hh, Ww, Ww, Wo, Wo, Wo, Wo, Wo, Ww, Ww, Ww, Gg, Gg, Gg, Gg, Gg, Gg, Gg, Gg, Gg, Gg, Gg, Gg, Gg, Gg, Gg, Gg, Gg, Gg, Gg, Gg, Ce, 1 Ke, Ce, Gs^Fp, Gs^Fp, Gs^Fp, Gg^Vc, Gs^Fp, Gs^Fp, Gs^Fp
Hh, Hh, Ww, Wo, Wo, Wo, Wo, Wo, Wo, Wo, Ww, Ww, Ww^Bw|, Gg, Gg, Gg, Gg, Gg, Ww, Ww, Ww, Ww, Ww, Gg^Vc, Gg, Gg, Gg, Gg, Gg, Gg, Gs^Fp, Gg, Gg, Ce, Gg, Gs^Fp, Gs^Fp, Gs^Fp, Gs^Fp, Gs^Fp, Gs^Fp, Gs^Fp
Mm, Mm, Ww, Ww, Ww, Ww, Ww, Ww, Ww, Ww, Ww, Ww, Ww^Bw|, Ww, Ww, Ww, Ww, Ww, Ww, Ww, Ww, Ww, Ww, Ww, Ww, Gg, Gg, Gg, Gg, Gg, Gg, Gg, Gg, Gs^Fp, Gs^Fp, Gg, Gg, Gs^Fp, Gs^Fp, Gs^Fp, Gg, Gg
Mm, Mm, Mm, Ww, Hh, Ww, Gg, Ww, Ww, Ww, Gs^Fp, Gs^Fp, Gg, Ww, Ww, Ww, Ww, Ww, Gg, Gg, Gg, Gg, Gs^Fp, Ww, Ww, Ww, Ww, Gg, Gg, Gs^Fp, Gs^Fp, Gs^Fp, Gs^Fp, Gs^Fp, Gs^Fp, Re, Gs^Fp, Gg^Fet, Gs^Fp, Gs^Fp, Gg, Gg
Mm, Mm, Mm, Hh, Hh, Hh, Hh, Gg, Gg, Gg, Gs^Fp, Gs^Fp, Gg, Gg, Gg, Gg, Ww, Gg, Gg, Gg, Ss, Ss, Ss, Gs^Fp, Gs^Fp, Ww, Ww, Ww, Ww, Gg, Gs^Fp, Gg^Fet, Gg^Vo, Gg, Re, Re, Gg, Gs^Fp, Gg^Fet, Gs^Fp, Hh, Hh
Mm, Mm, Mm, Hh, Hh, Hh, Hh, Gg, Gs^Fp, Gs^Fp, Gs^Fp, Gs^Fp, Gs^Fp, Gg, Gg, Gg, Ss, Gs^Fp, Ss, Ss, Ss, Ss, Ss, Ss, Gs^Fp, Gs^Fp, Gs^Fp, Ww, Ww, Ww, Ww, Gs^Fp, Gs^Fp, Gs^Fp, Gs^Fp, Gs^Fp, Gg, Gg, Gs^Fp, Gs^Fp, Hh, Hh
Mm, Mm, Mm, Mm, Mm, Hh, Hh, Gg, Gg, Re, Gg, Gs^Fp, Gs^Fp, Gg, Gs^Fp, Ss, Ss, Ss, Ss, Gs^Fp, Gs^Fp, Ss^Vhs, Ss, Ss, Ss, Gs^Fp, Ss, Gg, Gg, Ww, Ww, Ww, Gg, Gs^Fp, Re, Gs^Fp, Gs^Fp, Gs^Fp, Hh, Hh, Hh, Hh
Mm, Mm, Mm, Mm, Mm, Hh, Hh, Gs^Fp, Gs^Fp, Re, Re, Gs^Fp, Gs^Fp, Gs^Fp, Gg, Ss, Ss, Ss^Vhs, Ss, Gs^Fp, Ss, Ss, Ss, Ss, Ss, Ss, Ss, Gs^Fp, Gs^Fp, Ww, Ww, Ww, Gg, Gg^Fet, Re, Gg, Gs^Fp, Gg, Hh, Hh, Hh, Hh
Mm, Mm, Mm, Mm, Hh, Hh, Hh, Gs^Fp, Gs^Fp, Gs^Fp, Gg, Gg, Gg, Gg, Gg, Ss, Ss, Ss, Ss, Ss, Ss, Ss, Ss^Vhs, Ss, Ss, Ss, Ss, Gs^Fp, Gs^Fp, Gg, Ww, Ww, Gs^Fp, Gg, Gg, Gs^Fp, Hh^Vo, Hh, Hh, Hh, Hh, Hh
Mm, Mm, Mm, Mm, Mm, Hh, Hh, Gg, Gs^Fp, Gg, Gg^Efm, Gg^Efm, Gg, Gs^Fp, Gg, Gg, Gg, Ss, Ss, Ss, Ss, Ss, Ss, Ss, Ss, Ss, Ss, Ww, Ww, Ww, Ww, Ww, Ww^Bw/, Re, Gg, Re, Re, Hh, Re, Hh, Hh, Hh
Mm^Xm, Mm^Xm, Mm, Mm, Mm, Mm, Hh, Gg, Gg, Gs^Fp, Gs^Fp, Gg, Gs^Fp, Gg, Gs^Fp, Gs^Fp, Gs^Fp, Ss, Ss, Ss, Ss, Ss, Ss, Ss, Gs^Fp, Ss, Ss, Gg, Gg, Gg, Gg, Ww^Bw/, Ww, Ww, Gs^Fp, Hh, Hh, Re, Gg, Re, Re, Re
Mm^Xm, Mm^Xm, Mm^Xm, Mm, Mm^Xm, Hh^Vo, Mm, Gg, Gs^Fp, Gg, Gs^Fp, Gg, Gs^Fp, Gg, Co, Gs^Fp, Gs^Fp, Ss, Ss, Ss, Ss, Ss, Ss, Ss, Ss, Ss, Gs^Fp, Gg, Re, Re, Gg, Gg, Ww, Ww, Ww, Gg, Ww, Gg, Gg, Gg, Gg, Gg
Mm, Mm, Mm^Xm, Mm^Xm, Mm, Mm, Mm, Gg, Gs^Fp, Gg, Gs^Fp, Gg, Gg, Co, 3 Ko, Co, Gs^Fp, Gs^Fp, Gs^Fp, Gs^Fp, Gs^Fp, Gs^Fp, Gs^Fp, Ss, Gs^Fp, Gs^Fp, Gg, Gg, Re, Gs^Fp, Gg, Gg, Gg, Ww, Ww, Ww, Ww, Ww, Ww, Ww, Ww, Ww
Mm, Mm, Mm, Mm, Gg, Mm, Gg, Gg, Gs^Fms, Gs^Fms, Gs^Fms, Gg, Gs^Fp, Co, Co, Co, Gg, Gs^Fp, Gs^Fp, Gs^Fp, Gg, Gs^Fp, Gg, Gs^Fp, Gg, Gg, Gg, Gg, Gg, Gs^Fp, Gg, Gg, Gg^Efm, Ww, Ww, Ww, Ww, Ww, Ww, Ww, Ww, Ww
Gg, Gg, Gs^Fds, Gs^Fds, Gs^Fds, Gs^Fds, Gs^Fds, Gg, Gs^Fds, Gs^Fds, Gg^Fet, Gs^Fp, Gg^Fet, Gs^Fp, Gs^Fp, Gg, Gs^Fp, Gg^Vo, Re, Re, Re, Gg, Gg, Gg, Gg, Gg, Re, Re, Gg, Gg, Gg, Gg, Gg, Gg, Gg, Gg^Vo, Gg, Ww, Ww, Ww, Ww, Ww
Gs^Fds, Gs^Fds, Gs^Fds, Gg^Vo, Gs^Fds, Gg^Fet, Gg, Gg, Re, Gs^Fms, Gs^Fp, Gg^Fet, Gs^Fp, Gs^Fp, Re, Gg, Gg, Gg, Gs^Fp, Gg, Gg, Gg, Gg, Gg, Gg, Re, Gg, Gg, Gg, Gg, Gg^Efm, Gg, Gg, Gg, Gg^Efm, Gg, Gg, Gg, Gs^Fds, Ww, Ww, Ww
Gs^Fds, Gs^Fds, Re, Gs^Fds, Gg, Gs^Fds, Gg, Gg, Gs^Fms, Re, Gg, Gg, Re, Re, Gg, Gg, Gg, Gs^Fp, Hh, Hh, Hh, Gg, Gg^Vo, Gg, Gg, Gg, Gs^Fp, Gg, Gg, Gg, Gg, Gg, Gg, Gg, Gg, Gg, Gg, Gg, Gs^Fms, Gs^Fms, Gs^Fds, Gs^Fds
Re, Re, Gg, Re, Re, Gs^Fds, Re, Re, Gs^Fms, Gg^Vo, Gs^Fms, Gs^Fds, Gg, Gs^Fds, Gs^Fms, Gs^Fp, Hh, Hh, Hh, Hh, Hh, Gg, Gg, Gg, Gg, Gs^Fp, Gs^Fms, Gs^Fp, Gg, Gg, Gg, Gg, Gg, Gg, Gg, Gg^Efm, Gs^Fds, Gg, Gs^Fds, Gs^Fds, Gs^Fds, Gs^Fds
Gg, Gg, Gs^Fms, Gs^Fms, Gs^Fds, Re, Gs^Fms, Gs^Fms, Gg^Fet, Gs^Fms, Gg, Gg, Gg, Gg, Hh, Hh, Hh, Hh, Hh, Gg^Fet, Hh, Hh, Gs^Fp, Gg, Gg, Gs^Fp, Gg, Gs^Fms, Gs^Fds, Gg, Gs^Fds, Gs^Fds, Co, Co, Co, Re, Re, Gg, Gs^Fms, Gs^Fds, Gg, Gg
Gg, Gg, Gg, Gs^Fms, Gs^Fds, Gs^Fds, Gs^Fds, Gg^Vo, Gs^Fms, Gs^Fds, Gs^Fms, Gg, Gg, Gg, Hh, Hh, Gg^Fet, Hh, Hh, Hh, Gg^Vo, Hh, Gs^Fp, Gg, Gg, Gg, Gg, Gg, Gg, Gs^Fms, Gs^Fds, Gs^Fds, Co, 4 Ko, Co, Gg, Gg, Re, Re, Gg, Gg, Gg
Mm, Mm, Mm, Gg, Gg, Gs^Fds, Gg, Gs^Fds, Gs^Fms, Gs^Fds, Gs^Fds, Gs^Fp, Gs^Fp, Hh, Hh, Gg^Fet, Gg^Fet, Hh, Gg^Fet, Gg^Fet, Hh, Hh, Hh, Gs^Fp, Gg, Gg, Gg, Gg, Gg, Gg^Vo, Gg, Gg, Gg, Co, Gs^Fds, Gs^Fds, Gs^Fds, Gg, Gs^Fms, Gg, Re, Re
Mm, Mm, Mm, Mm, Mm, Mm, Mm, Mm, Mm, Gs^Fds, Gs^Fds, Gs^Fms, Gs^Fp, Hh, Hh, Hh, Hh, Hh, Hh, Hh, Hh, Hh, Hh, Gs^Fp, Gs^Fp, Gs^Fp, Gs^Fp, Gg, Gg, Gg, Gg, Gg, Gg, Gs^Fds, Gg, Gs^Fds, Gs^Fds, Gs^Fds, Gg, Gg, Gg, Gg
Mm, Mm, Mm, Mm, Mm, Mm, Mm, Mm, Mm, Gs^Fms, Gs^Fms, Gs^Fp, Gs^Fp, Hh, Hh, Hh, Hh, Hh, Hh, Hh, Hh, Hh, Hh, Gs^Fp, Gs^Fp, Gs^Fp, Gs^Fp, Gg, Gg, Gg, Gg, Gg, Gg, Gs^Fms, Gg, Gs^Fds, Gs^Fms, Gs^Fms, Gg, Gg, Gg, Gg
