Ur, Xos, Xol, Xol, Xos, Xos, Xos, Xos, Xos, Xos, Xol, Xos, Xos, Xos, Xos, Xos, Xos, Xos, Xos, Xos, Xos, Xos, Xos, Xos, Xos, Xos, Xos, Xos, Xos, Xos, Xos, Xos
Xos, Ur, Ur, Xol, Xos, Xos, Xos, Xos, Iwr, Iwr, Iwr, Xol, Xos, Xos, Xol, Xos, Iwr, Iwr, Iwr, Xol, Xol, Xos, Iwr, Iwr, Iwr, Xos, Xos, Xos, Xos, Xos, Xos, Xos
Xos, Xos, Iwr, Iwr, Xos, Xos, Iwr, Iwr, Iwr, Iwr, Iwr, Iwr, Xos, Xol, Iwr, Iwr, Iwr, Iwr, Iwr, Iwr, Xol, Xol, Iwr^Pr\, Iwr, Iwr, Iwr, Xos, Xos, Iwr, Xos, Xos, Xos
Xos, Iwr, Iwr, Xos, Xos, Iwr, Iwr, Iwr, Iwr, Iwr, Xos, Xos, Iwr, Iwr, Iwr, Iwr, Iwr, Iwr, Xos, Xos, Iwr, Iwr, Xol, Xos, Xos, Xos, Iwr, Iwr, Iwr, Iwr, Iwr, Xos
Xos, Xos, Xos, Iwr, Iwr, Xos, Xos, Iwr, Xos, Iwr^Pr/, Iwr, Xos, Xol, Iwr, Iwr, Iwr, Xos, Iwr^Pr/, Iwr, Iwr, Iwr^Pr/, Xol, Iwr, Iwr, Iwr, Xos, Iwr^Pr\, Iwr, Iwr, Iwr, Xos, Xos
Xos, Xos, Xos, Xos, Xos, Iwr, Xos, Xos, Xos, Xos, Xos, Iwr, Iwr, Xol, Xos, Xos, Iwr, Iwr, Xos, Xos, Xos, Iwr, Iwr, Iwr, Iwr, Iwr, Iwr, Xos, Xol, Xos, Xos, Xos
Xos, Xos, Xos, Xos, Xos, Xos, Xos, Xos, Xol, Xos, Iwr, Xos, Xos, Iwr, Iwr, Iwr, Iwr^Pr/, Xos, Iwr, Iwr, Iwr, Xos, Xos, Iwr, Iwr, Iwr, Iwr, Iwr, Iwr, Xol, Xos, Xos
Xos, Xos, Xos, Xos, Xos, Xos, Xos, Xol, Iwr, Iwr, Iwr, Iwr, Iwr, Xos, Xol, Xos, Iwr, Iwr, Iwr, Iwr, Iwr, Iwr, Iwr, Xos, Xol, Iwr, Iwr, Iwr, Iwr, Iwr, Iwr, Xos
Xos, Xos, Xos, Xos, Xos, Xos, Iwr, Iwr, Iwr, Iwr, Iwr, Iwr, Xos, Xol, Iwr, Iwr, Iwr, Iwr, Iwr, Iwr, Iwr, Iwr, Xos, Xol, Iwr, Iwr^Pr\, Xol, Iwr, Iwr, Iwr, Xos, Xos
Xos, Xos, Xos, Xos, Iwr, Xos, Iwr^Pr\, Iwr, Iwr, Iwr, Xos, Iwr^Pr/, Iwr, Iwr, Iwr, Iwr, Iwr, Iwr, Iwr, Iwr, Xol, Xol, Iwr, Iwr, Iwr, Iwr, Iwr, Xol, Xos, Xos, Xos, Xos
Xol, Xol, Iwr, Iwr, Iwr, Iwr, Iwr, Xos, Xos, Xos, Iwr, Xol, Xol, Iwr, Iwr, Iwr, Iwr, Iwr, Xol, Xos, Iwr, Iwr, Iwr, Iwr, Iwr, Iwr, Iwr, Iwr, Xos, Xos, Xos, Xos
Xos, Iwr, Iwr, Iwr, Iwr, Iwr, Xol, Xol, Iwr, Iwr, Iwr, Iwr, Iwr, Xos, Iwr^Pr\, Iwr, Xos, Xol, Iwr, Iwr, Iwr, Iwr, Iwr, Iwr, Iwr, Iwr, Xos, Xos, Iwr, Xol, Xol, Xos
Xos, Xos, Xos, Iwr, Xos, Xos, Iwr, Iwr, Iwr, Iwr, Iwr, Iwr, Iwr, Iwr, Iwr, Xol, Xol, Iwr, Iwr, Iwr, Iwr, Iwr, Iwr, Iwr, Xol, Xos, Iwr, Iwr, Iwr, Iwr, Iwr, Xos
Xos, Xos, Xos, Xos, Xos, Iwr, Iwr, Iwr, Iwr, Iwr, Iwr, Iwr, Iwr, Iwr, Iwr, Iwr, Iwr, Xos, Xos, Iwr, Iwr, Iwr, Iwr^Pr/, Xos, Iwr, Xos, Iwr^Pr\, Iwr, Iwr, Iwr, Xos, Xos
Xos, Xos, Xos, Xos, Xol, Xos, Xos, Iwr, Iwr, Iwr, Iwr, Iwr, Iwr, Iwr, Iwr, Iwr, Iwr, Iwr, Xos, Xos, Xos, Xos, Iwr, Iwr, Iwr, Iwr, Iwr, Xol, Xol, Xos, Xos, Xos
Xos, Xos, Xos, Xol, Iwr, Iwr, Iwr, Iwr^Pr\, Xos, Iwr, Iwr, Iwr, Iwr, Iwr, Iwr, Iwr, Iwr^Pr/, Xos, Iwr, Iwr, Iwr, Xol, Xol, Iwr, Iwr, Iwr, Iwr, Iwr, Iwr, Xos, Xos, Xos
Xos, Xos, Xos, Iwr, Iwr, Iwr, Iwr, Iwr, Iwr, Xos, Xos, Iwr, Iwr, Iwr, Xol, Xol, Iwr, Iwr, Iwr, Iwr, Iwr, Iwr, Iwr, Xos, Iwr^Pr\, Iwr, Iwr, Iwr, Iwr, Iwr, Xos, Xos
Xos, Xos, Xos, Xos, Xos, Iwr, Iwr, Iwr, Iwr^Pr/, Xos, Iwr, Xol, Xol, Xos, Iwr, Iwr, Iwr, Iwr, Iwr, Iwr, Iwr, Iwr, Iwr, Iwr, Iwr, Xos, Xos, Iwr, Xos, Xos, Xos, Xos
Xos, Xos, Xos, Xos, Xos, Xos, Xos, Xos, Iwr, Iwr, Iwr, Iwr, Iwr, Xos, Xos, Iwr, Iwr, Iwr, Iwr, 1 Iwr, Iwr, Iwr, Iwr, Iwr, Iwr, Iwr, Xos, Xos, Xos, Xos, Xos, Xos
Xos, Xos, Xos, Xos, Xos, Xos, Xos, Xos, Xos, Iwr, Iwr, Iwr, Xos, Xos, Xos, Xos, Xol, Iwr, Iwr, Iwr, Iwr, Iwr, Iwr, Iwr, Xos, Xos, Xos, Xos, Xos, Xos, Xos, Xos
Xos, Xos, Xos, Xos, Xos, Xos, Xos, Xos, Xos, Xos, Xos, Xos, Xos, Xos, Xos, Xol, Iwr, Iwr, Xos, Iwr, Iwr, Iwr, Xos, Xos, Xos, Xos, Xos, Xos, Xos, Xos, Xos, Xos
Xos, Xos, Xos, Xos, Xos, Xos, Xos, Xos, Xos, Xos, Xos, Xos, Xos, Xos, Xos, Iwr, Xos, Xos, Xos, Xos, Xos, Xos, Xos, Xos, Xos, Xos, Xos, Xos, Xos, Xos, Xos, Xos
