Uh, Uh, Uh, Xu, Xu, Xu, Uu^Uf, Uu, Xu, Xu, Uu, Uu, Uu, Uu, Rr, Rr, Rr, Rr, Uu, Uu, Xu, Uu, Uu, Uu, Uu, Uu, Uu, Uu, Uu, Uu, Xu, Xu, Xu, Xu, Xu, Xu, Xu, Xu
Uh, Uh, Uh, Xu, Xu, Xu, Uu^Uf, Uu, Xu, Xu, Uu, Uu, Cud, Uu, Rr, Rr, Rr, Rr, Uu, Uu, Uu^Uf, Xu, Xu, Uu, Uh, Uu, Uu, Uu, Uh, Uu, Xu, Xu, Xu, Xu, Xu, Xu, Xu, Xu
Uu^Uf, Uu^Uf, Uu^Vud, Xu, Ww, Ww, Uu, Uu, Uu, Uu, Uu, Uu, Rr, Rr, Rr, Rr, Rr, Rr, Uu, Uu, Xu, Uu, Uu, Uu, Uu, Uu, Uu^Uf, Uu, Uu, Uu, Xu, Xu, Xu, Xu, Xu, Xu, Xu, Xu
Rr, Rr, Rr, Uu, Uu, Uu, Rr, Rr, Rr, Uu^Vud, Rr, Rr, Rr, Rr, Rr, Rr, Cud, Uu, Uu, Xu, Xu, Xu, Xu, Xu, Xu, Uu^Uf, Uu^Uf, Uu^Uf, Uh, Xu, Xu, Xu, Xu, Xu, Xu, Xu, Xu, Xu
Uu^Uf, Uu^Uf, Uu^Uf, Rr, Rr, Rr, Cud, Cud, Cud, Rr, Rr, Rr, Rr, Rr, Rr, Uu, Rr, Uu, Xu, Xu, Xu, Xu, Xu, Xu, Xu, Xu, Xu, Xu, Xu, Xu, Xu, Xu, Xu, Xu, Xu, Xu, Xu, Xu
Uh, Uh, Uu^Vud, Rr, Rr, Cud, Rr, Cud, Rr, Rr, Rr, Cud, Rr, Uu^Vud, Uu, Rr, Rr, Uu, Rd, Xu, Xu, Xu, Uh, Xu, Uu^Uf, Xu, Uh, Xu, Xu, Xu, Xu, Xu, Xu, Xu, Xu, Xu, Xu, Xu
Xu, Xu, Xu, Uu, Rr, Cud, Rr, Rr, Rr, Cud, 2 Kud, Cud, Rr, Uu, Xu, Uu, Xu, Rd, Re, Rd, Uu, Uh, Rd, Re, Rd, Uh, Uu, Uh, Xu, Xu, Xu, Xu, Xu, Xu, Xu, Xu, Xu, Xu
Xu, Xu, Re, Re, Uh, Rr, Rr, Cud, Cud, Rr, Cud, Cud, Rr, Uu, Cud, Xu, Xu, Xu, Uu^Uf, Re, Rd, Re, Uu, Rd, Uu, Re, Re, Uh, Xu, Xu, Xu, Xu, Xu, Xu, Xu, Xu, Xu, Xu
Uu, Uu, Re, Xu, Xu, Xu, Xu, Rr, Rr, Rr, Rr, Rr, Rr, Uu, Uu, Xu, Uu, Xu, Uu, Rd, Uh, Rd, Xu, Xu, Uu, Rd, Rd, Rd, Xu, Xu, Xu, Xu, Xu, Xu, Xu, Xu, Xu, Xu
Qxu, Qxu, Uu, Uu, Uh, Xu, Xu, Uu, Uu^Uf, Uu, Uu^Vud, Rr, Rr, Uu, Uu, Uu, Ww, Ww, Ww, Ww, Wo, Xu, Xu, Xu, Uh, Uu, Re, Uu, Uu^Uf, Xu, Xu, Xu, Xu, Xu, Xu, Xu, Xu, Xu
Qxu, Qxu, Qxu, Qxu, Qxu, Uu, Xu, Uu^Vud, Xu, Xu, Xu, Uu, Rr, Rr, Uu, Uu, Xu, Wo, Wo, Wo, Xu, Xu, Xu, Xu, Uh, Uh, Rd, Uu, Uu, Uh, Xu, Xu, Xu, Xu, Xu, Xu, Xu, Xu
Qxu, Qxu, Qxu, Uh, Re, Uu, Xu, Xu, Uh, Xu, Uu, Uu, Rr, Rr, Uu, Uu, Xu, Xu, Xu, Xu, Xu, Xu, Xu, Xu, Xu, Uu, Uu, Re, Rd, Re, Rd, Xu, Xu, Xu, Xu, Xu, Xu, Xu
Xu, Xu, Uu, Uu, Re, Xu, Xu, Uh, Uh, Xu, Uu, Rr, Xu, Uu, Rr, Uu, Uu, Xu, Xu, Xu, Xu, Xu, Xu, Xu, Ql, Xu, Xu, Rd, Uh, Rd, Re, Uu^Vu, Re, Uh, Uu^Vu, Xu, Xu, Xu
Xu, Xu, Uu, Uu, Uh, Re, Uu, Uu, Uu, Xu, Uu, Rr, Uu, Uu, Rr, Rr, Rr, Uu, Uu, Xu, Xu, Xu, Ql, Ql, Uu, Ql, Xu, Xu, Xu, Uu, Rd, Re, Uu^Uf, Re, Re, Xu, Xu, Xu
Xu, Xu, Re, Re, Uu, Uu, Uh, Uu, Xu, Xu, Uu, Rr, Uu, Uu, Uu, Rr, Uu, Rr, Uu, Xu, Xu, Xu, Ql, Uu, Ql, Ql, Xu, Xu, Uu, Uu^Vu, Rd, Uu^Uf, Uu, Uu^Vu, Re, Xu, Xu, Xu
Xu, Xu, Uh, Xu, Xu, Uu, Uu, Uu, Xu, Xu, Rd, Rd, Rd, Xu, Xu, Uu, Uu, Uu, Rr, Uu, Uu, Xu, Uu, Uu, Ql, Xu, Xu, Xu, Uu, Rd, Uu^Uf, Uu^Uf, Uu^Uf, Re, Uu^Vu, Xu, Xu, Xu
Xu, Xu, Xu, Re, Uu, Xu, Xu, Xu, Uu^Uf, Re, Uu, Uu, Xu, Xu, Xu, Xu, Xu, Uu, Rr, Rr, Rr, Uu, Xu, Xu, Xu, Xu, Xu, Uu^Uf, Xu, Re, Re, Uu^Uf, Rd, Rd, Rd, Xu, Xu, Xu
Xu, Xu, Re, Uh, Xu, Xu, Uu, Re^Uf, Re^Uf, Re^Uf, Re, Xu, Xu, Xu, Xu, Xu, Xu, Uh, Uu, Rr, Rr, Uu, Xu, Xu, Xu, Xu, Xu, Xu, Xu, Uu^Vu, Re, Uu, Re, Re, Uu^Vu, Xu, Xu, Xu
Xu, Xu, Re, Xu, Re, Re, Uu^Vud, Uu, Uu, Uu, Uu, Rd, Rd, Xu, Xu, Xu, Xu, Xu, Uu, Uu, Uu, Uu, Uu, Xu, Xu, Xu, Uh, Xu, Re, Xu, Rd, Re, Uu^Vu, Xu, Xu, Xu, Xu, Xu
Xu, Xu, Uu, Uu^Uf, Uu, Ww, Ww, Ww, Ww, Ww, Ww, Uu^Vu, Uu, Uu^Uf, Uh, Xu, Xu, Xu, Xu, Uu, Rr, Uu, Uu, Xu, Xu, Xu, Rd, Re, Uu, Rd, Uu, Rd, Xu, Xu, Xu, Xu, Qxu, Qxu
Xu, Xu, Uu, Uu, Ww, Ww, Ww, Ww, Ww, Wo, Wo, Ww, Uu^Uf, Uh, Xu, Xu, Xu, Xu, Xu, Uu, Rr, Rr, Uu, Xu, Xu, Xu, Rd, Re, Xu, Uu, Xu, Xu, Xu, Xu, Xu, Qxu, Qxu, Qxu
Xu, Xu, Rd, Rd, Uu^Vud, Ww, Ww, Gg^Fet, Ww, Ww, Ww, Ww, Re, Re^Uf, Uu^Uf, Xu, Xu, Xu, Xu, Xu, Uu, Rr, Uu, Xu, Xu, Xu, Uu, Uu, Xu, Xu, Uu^Uf, Xu, Uh, Xu, Uu, Qxu, Qxu, Qxu
Re^Uf, Re^Uf, Rd, Re, Uu, Rr, Rr, Uu^Vu, Rr, Rr, Rr, Uu^Vud, Uu, Uu, Uh, Uh, Xu, Xu, Uh, Xu, Uh, Uu, Uu, Uu, Uu, Uu, Rr, Uu, Xu, Xu, Uu, Uh, Qxu, Qxu, Qxu, Qxu, Qxu, Qxu
Xu, Xu, Uu^Uf, Uu, Uu, Uu, Ww, Ww, Ww, Ww, Uu, Uu, Re, Xu, Xu, Xu, Xu, Xu, Uh, Uu^Uf, Rr, Rr, Rr, Uu, Uu, Uu, Rr, Rr, Uu, Xu, Uu, Qxu, Qxu, Qxu, Qxu, Qxu, Qxu, Qxu
Xu, Xu, Uu^Uf, Rd, Uu^Vu, Ww, Ww, Wo, Ww, Uu^Vud, Rd, Re, Uu, Xu, Uu, Xu, Uu, Xu, Rr, Uu, Uu, Rr, Uu, Rr, Uu, Uu, Uu, Rr, Uu, Uu, Chr, Qxu, Qxu, Qxu, Qxu, Qxu, Qxu, Qxu
Xu, Xu, Rd, Re, Uu, Ww, Rd, Ww, Uu, Uu, Re, Rd, Uu, Rd, Rd, Uu, Rr, Rr, Rr, Uu, Uu, Rr, Uu, Uu, Rr, Rr, Rr, Uu, Chr, Uu, Khr, Qxu, Qxu, Qxu, Qxu, Qxu, Qxu, Qxu
Xu, Xu, Uu, Re, Re, Uu, Rd, Re, Re, Rd, Uu^Uf, Rd, Xu, Rd, Uu, Uu, Uu, Uu, Xu, Uu, Uu, Uu, Uu, Uu, Uu, Uu, Uu, Uu, Uu, Chr, Chr, Qxu, Qxu, Qxu, Qxu, Qxu, Qxu, Qxu
Xu, Xu, Xu, Uu^Vud, Xu, Rd, Re, Uu^Vud, Xu, Uu^Uf, Xu, Xu, Xu, Xu, Xu, Xu, Xu, Xu, Xu, Xu, Uu, Rr, Rr, Uu, Xu, Uu, Qxu, Qxu, Qxu, Qxu, Qxu, Qxu, Qxu, Qxu, Qxu, Qxu, Qxu, Qxu
Xu, Xu, Xu, Xu, Xu, Xu, Xu, Xu, Xu, Xu, Xu, Xu, Xu, Xu, Xu, Xu, Xu, Xu, Xu, Xu, Uu, Rr, Rr, Uu, Xu, Uu, Qxu, Qxu, Qxu, Qxu, Qxu, Qxu, Qxu, Qxu, Qxu, Qxu, Qxu, Qxu
Xu, Xu, Xu, Xu, Xu, Xu, Uh, Xu, Xu, Xu, Xu, Xu, Uu, Xu, Uu, Xu, Xu, Xu, Xu, Xu, Uu, Rr, Uu, Uu, Uu, Uu, Uu^Uf, Qxu, Qxu, Qxu, Qxu, Qxu, Qxu, Qxu, Qxu, Qxu, Qxu, Qxu
Xu, Xu, Xu, Xu, Uh, Uu^Uf, Uu, Uu^Uf, Uu^Uf, Xu, Uh, Uu, Uh, Uu, Uu, Uu, Uu, Uu^Uf, Uu, Xu, Uu, Uu, Uu, Uu, Uu, Uu, Uu, Qxu, Qxu, Qxu, Qxu, Qxu, Qxu, Qxu, Qxu, Qxu, Qxu, Qxu
Xu, Xu, Xu, Uh, Uu, Uu, Uu, Uu, Uu, Xu, Xu, Uh, Xu, Xu, Xu, Uu, Uu, Uu, Uu, Uu, Uu, Uu, Xu, Uu, Xu, Uu, Uu, Qxu, Qxu, Qxu, Qxu, Qxu, Qxu, Qxu, Qxu, Qxu, Qxu, Qxu
Xu, Xu, Xu, Uu, Uu, Uu, Uu, Uu, Uu, Uh, Xu, Xu, Xu, Xu, Xu, Xu, Xu, Xu, Xu, Uu, Uu, Uu, Uu, Uu, Xu, Xu, Xu, Qxu, Qxu, Qxu, Qxu, Qxu, Qxu, Qxu, Qxu, Qxu, Qxu, Qxu
Mm, Xu, Xu, Uu, Uu, Uu, Uu, Uu, Uh, Xu, Xu, Xu, Xu, Xu, Xu, Xu, Xu, Xu, Uu^Uf, Xu, Uu, Uu, Uu, Xu, Uh, Xu, Xu, Uu, Qxu, Qxu, Qxu, Qxu, Qxu, Qxu, Qxu, Qxu, Qxu, Qxu
Mm, Uh, Re, 1 Uu, Uh, Uu, Uu^Uf, Uu^Uf, Uh, Xu, Xu, Xu, Xu, Xu, Xu, Xu, Xu, Uh, Uh, Uh, Xu, Xu, Xu, Uu, Uu^Uf, Uh, Xu, Uu, Qxu, Qxu, Qxu, Qxu, Qxu, Qxu, Qxu, Qxu, Qxu, Qxu
Mm, Xu, Xu, Xu, Xu, Xu, Xu, Xu, Xu, Xu, Xu, Xu, Xu, Xu, Xu, Xu, Xu, Xu, Xu, Xu, Xu, Xu, Xu, Uu^Uf, Xu, Uh, Xu, Uu^Uf, Uu, Qxu, Qxu, Qxu, Qxu, Qxu, Qxu, Qxu, Qxu, Qxu
Xu, Xu, Xu, Xu, Xu, Xu, Xu, Xu, Xu, Xu, Xu, Xu, Xu, Xu, Xu, Xu, Xu, Xu, Xu, Xu, Xu, Xu, Xu, Xu, Xu, Xu, Xu, Xu, Xu, Qxu, Qxu, Qxu, Qxu, Qxu, Qxu, Qxu, Qxu, Qxu
